Ms, Aa, Aa, Aa, Aa, Wwf, Gll, Gll, Gll^Emf, Gg, Hd, Gll, Xv, Gll, Hd, Gg, Gll^Emf, Gll, Gll, Wwf, Aa, Aa, Aa, Aa, Ms
Ms, Aa, Aa, Aa, 4 Aa, Wwf, Wwf, Gll, Gll, Gll, Hd, Dd, Xv, Dd, Hd, Gll, Gll, Gll, Wwf, Wwf, 6 Aa, Aa, Aa, Aa, Ms
Ha, Ms, Wwf, Gg, Gll, Gll^Fdf, Gll, Wwf, Ds^Ftd, Hd, Gd, Gd, Xv, Gd, Gd, Hd, Ds^Ftd, Wwf, Gll, Gll^Fdf, Gll, Gg, Wwf, Ms, Ha
Ha, Aa, Gg, Wwf, Wwf, Gll^Fdf, Gll, Wwf, Wwf, Dd^Vdt, Ds, Md, Xv, Md, Ds, Dd^Vdt, Wwf, Wwf, Gll, Gll^Fdf, Wwf, Wwf, Gg, Aa, Ha
Hhd, Gg, Gg, Gg, Gll, Wwf, Gll^Fdf, Gll, Md, Wwf, Wwf, Dd^Do, Xv, Dd^Do, Wwf, Wwf, Md, Gll, Gll^Fdf, Wwf, Hhd^Fmw, Gg, Gg, Gg, Hhd
Ww^Ewl, Md, Gd^Vhr, Gll^Fmw, Gd, Wwf, Wwf, Gd, Gd, Hh^Fmf, Wwf, Gd, Xv, Gd, Wwf, Hh^Fmf, Gd, Gd, Wwf, Wwf, Gd, Gll^Fmw, Gd^Vhr, Md, Ww^Ewl
Ss, Wwf, Wwf, Gg, Hh^Fms, Gd, Wwf, Gll^Fmf, Gll^Fmf, Dd^Do, Wwf, Gd, Xv, Gd, Wwf, Dd^Do, Gll^Fmf, Gll^Fmf, Wwf, Gd, Hh^Fms, Gg, Wwf, Wwf, Ss
Gg, Ss, Wwf^Ewl, Gs^Fms, Dd^Do, Gg, Ww^Vm, Gd, Wwf, Wwf, Wwf^Ewl, Ss, Xv, Ss, Wwf^Ewl, Wwf, Wwf, Gd, Ww^Vm, Gg, Dd^Do, Gs^Fms, Wwf^Ewl, Ss, Gg
Gg, Gg, Gg, Wwf, Wwf^Bsb/, Gg, Wwf, Wwr, Gd, Hhd^Uf, Gs, Gll^Fp, Xv, Gll^Fp, Gs, Hhd^Uf, Gd, Wwr, Wwf, Gg, Wwf^Bsb\, Wwf, Gg, Gg, Gg
Gg, Gs^Vh, Gg, Gg, Mm, Wwf, Wwf, Gll^Fp, Hh, Gs, Gs^Vh, Uu^Uf, Xv, Uu^Uf, Gs^Vh, Gs, Hh, Gll^Fp, Wwf, Wwf, Mm, Gg, Gg, Gs^Vh, Gg
Gg, Dd^Do, Gg, Gg, Gs, Gg, Gs^Fms, Wwf, Dd^Do, Gs, Gs, Uu^Uf, Xv, Uu^Uf, Gs, Gs, Dd^Do, Wwf, Gs^Fms, Gg, Gs, Hh, Gg, Dd^Do, Gg
Gg, Gg, Gg, Gg, Gs, Gs^Vh, Md, Wwf, Wwf, Hh, Gll^Fp, Gll, Xv, Gll, Gll^Fp, Hh, Wwf, Wwf, Md, Gs^Vh, Gs, Gg, Gg, Gg, Gg
Gg, Cv, 1 Kv, Gg, Gs, Gs, Gg, Md, Gg, Wwf, 3 Cme^Kov, Ch, Xv, Ch, 2 Cme^Kov, Wwf, Gg, Md, Gg, Gs, Gs, Gg, 5 Kv, Cv, Gg
Gg, Dd^Do, Gg, Cv, Gs^Ft, Gs, Gg, Gg, Gg, Ch, Wwrg, Wot, Xv, Wot, Wwrg, Ch, Gg, Gg, Gg, Gs, Gs^Ft, Cv, Gg, Dd^Do, Gg
Gg, Gg, Gg, Gg, Gg, Dd^Ftd, Gg, Gll^Ftr, Gg, Hh, Wot, Wot, Xv, Wot, Wot, Hh, Gg, Gll^Ftr, Gg, Dd^Ftd, Gg, Gg, Gg, Gg, Gg
