Gll, Kh, Gll, Gll, Gll^Emf, Gg, Aa, Gll, Xv, Gll, Aa, Gg, Gll^Emf, Gll, Gll, Kh, Gll
Gll, Gd, Gll, Gll, Gll, Gll, Gll, Aa, Xv, Aa, Gll, Gll, Gll, Gll, Gll, Gd, Gll
Gll, Gd, Wwf, Gll, Gll, Gll, 2 Gll, Gll, Xv, Gll, 4 Gll, Gll, Gll, Gll, Wwf, Gd, Gll
Wwf, Gd, Wwf, Wwf, Wwf^Bsb|, Wwf, Wwf, Gll, Xv, Gll, Wwf, Wwf, Wwf^Bsb|, Wwf, Wwf, Gd, Wwf
Gll, Gd, Wwf^Bsb/, Gll, Gll, Gll, Wwf, Kh, Xv, Kh, Wwf, Gll, Gll, Gll, Wwf^Bsb\, Gd, Gll
Gd, Gd, Wwf, Gd, Gd, Gll, Wwf, Kh, Xv, Kh, Wwf, Gll, Gd, Gd, Wwf, Gd, Gd
Gd, Gd, Wwf, Hhd^Fp, Gd, Gd, Wwf, Kh, Xv, Kh, Wwf, Gd, Gd, Hhd^Fp, Wwf, Gd, Gd
Gd, Mm, Gs^Vh, Gll^Fp, Wwf, Wwf, Gd, Gd, Xv, Gd, Gd, Wwf, Wwf, Gll^Fp, Gs^Vh, Mm, Gd
Gd, Dd^Do, Wwf, Wwf, Gd, Hhd, Gs, Gll^Fp, Xv, Gll^Fp, Gs, Hhd, Gd, Wwf, Wwf, Dd^Do, Gd
Gs, Gd, Wwf, Gll^Fp, Hh, Gs, Gs^Vh, Gs, Xv, Gs, Gs^Vh, Gs, Hh, Gll^Fp, Wwf, Gd, Gs
Gs, 1 Kh, Gs^Fms, Wwf, Gs, Gs, Gs, Hh, Xv, Hh, Gs, Gs, Gs, Wwf, Gs^Fms, 3 Kh, Gs
Gs, Kh, Gs, Wwf, Wwf, Hh, Gll^Fp, Gs, Xv, Gs, Gll^Fp, Hh, Wwf, Wwf, Gs, Kh, Gs
Xv, Kh, Gs, Gs, Gs, Wwf, Wwf, Gg^Ve, Xv, Gg^Ve, Wwf, Wwf, Gs, Gs, Gs, Kh, Xv
Ql, Xv, Xv, Xv, Xv, Xv, Xv, Xv, Ql, Xv, Xv, Xv, Xv, Xv, Xv, Xv, Ql
Ql, Ql, Ql, Ql, Ql, Ql, Ql, Ql, Xv, Ql, Ql, Ql, Ql, Ql, Ql, Ql, Ql
