Gg, Gg, Gg, Gg, Gg, Gg, Gg, Gg, Gg, Gg, Gg, Gg, Xv, Gg, Gg, Gg, Gg, Gg, Gg, Gg, Gg, Gg, Gg, Gg, Gg
Gg, Gg, Aa, Aa, Aa, Gg, Aa, Aa, Aa, Gg, Aa, Aa, Xv, Aa, Aa, Gg, Aa, Aa, Aa, Gg, Aa, Aa, Aa, Gg, Gg
Gg, Aa, Gg, Gg, Gg, Aa, Gg, Gg, Gg, Aa, 2 Gg, Gg, Xv, Gg, 4 Gg, Aa, Gg, Gg, Gg, Aa, Gg, Gg, Gg, Aa, Gg
Gg, Aa, Aa, Gg, Gg, Gg, Gg, Gg, Gg, Gg, Gg, Gg, Xv, Gg, Gg, Gg, Gg, Gg, Gg, Gg, Gg, Gg, Aa, Aa, Gg
Gg, Gg, Gg, Aa, Gll, Kh, Gll, Gll, Gll^Emf, Gg, Aa, Gll, Xv, Gll, Aa, Gg, Gll^Emf, Gll, Gll, Kh, Gll, Aa, Gg, Gg, Gg
Gg, Gg, Aa, Aa, Gll, Gd, Gll, Gll, Gll, Gll, Gll, Aa, Xv, Aa, Gll, Gll, Gll, Gll, Gll, Gd, Gll, Aa, Aa, Gg, Gg
Gg, Aa, Gg, Gg, Gll, Gd, Wwf, Gll, Gll, Gll, Gll, Gll, Xv, Gll, Gll, Gll, Gll, Gll, Wwf, Gd, Gll, Gg, Gg, Aa, Gg
Gg, Aa, Aa, Gg, Wwf, Gd, Wwf, Wwf, Wwf^Bsb|, Wwf, Wwf, Gll, Xv, Gll, Wwf, Wwf, Wwf^Bsb|, Wwf, Wwf, Gd, Wwf, Gg, Aa, Aa, Gg
Gg, Gg, Gg, Aa, Gll, Gd, Wwf^Bsb/, Gll, Gll, Gll, Wwf, Kh, Xv, Kh, Wwf, Gll, Gll, Gll, Wwf^Bsb\, Gd, Gll, Aa, Gg, Gg, Gg
Gg, Gg, Aa, Aa, Gd, Gd, Wwf, Gd, Gd, Gll, Wwf, Kh, Xv, Kh, Wwf, Gll, Gd, Gd, Wwf, Gd, Gd, Aa, Aa, Gg, Gg
Gg, Aa, Gg, Gg, Gd, Gd, Wwf, Hhd^Fp, Gd, Gd, Wwf, Kh, Xv, Kh, Wwf, Gd, Gd, Hhd^Fp, Wwf, Gd, Gd, Gg, Gg, Aa, Gg
Gg, Aa, Aa, Gg, Gd, Mm, Gs^Vh, Gll^Fp, Wwf, Wwf, Gd, Gd, Xv, Gd, Gd, Wwf, Wwf, Gll^Fp, Gs^Vh, Mm, Gd, Gg, Aa, Aa, Gg
Gg, Gg, Gg, Aa, Gd, Dd^Do, Wwf, Wwf, Gd, Hhd, Gs, Gll^Fp, Xv, Gll^Fp, Gs, Hhd, Gd, Wwf, Wwf, Dd^Do, Gd, Aa, Gg, Gg, Gg
Gg, Gg, Aa, Aa, Gs, Gd, Wwf, Gll^Fp, Hh, Gs, Gs^Vh, Gs, Xv, Gs, Gs^Vh, Gs, Hh, Gll^Fp, Wwf, Gd, Gs, Aa, Aa, Gg, Gg
Gg, 1 Aa, Gg, Gg, Gs, Kh, Gs^Fms, Wwf, Gs, Gs, Gs, Hh, Xv, Hh, Gs, Gs, Gs, Wwf, Gs^Fms, Kh, Gs, Gg, Gg, 3 Aa, Gg
Gg, Aa, Aa, Gg, Gs, Kh, Gs, Wwf, Wwf, Hh, Gll^Fp, Gs, Xv, Gs, Gll^Fp, Hh, Wwf, Wwf, Gs, Kh, Gs, Gg, Aa, Aa, Gg
Xv, Gg, Gg, Aa, Gg, Kh, Gs, Gs, Gs, Wwf, Wwf, Gg^Ve, Xv, Gg^Ve, Wwf, Wwf, Gs, Gs, Gs, Kh, Gg, Aa, Gg, Gg, Xv
Ql, Xv, Xv, Xv, Xv, Xv, Xv, Xv, Xv, Xv, Xv, Xv, Ql, Xv, Xv, Xv, Xv, Xv, Xv, Xv, Xv, Xv, Xv, Xv, Ql
Gg, Ql, Ql, Ql, Ql, Ql, Ql, Ql, Ql, Ql, Ql, Ql, Xv, Ql, Ql, Ql, Ql, Ql, Ql, Ql, Ql, Ql, Ql, Ql, Gg
