Gll, Kh, Gll, Gll, Gll^Emf, Gg, Aa, Gll, Xv, Gll, Aa, Gg, Gll^Emf, Gll, Gll, Kh, Gll
Gll, Kh, Gll, 2 Gll, Gll, Gll, Gll, Aa, Xv, Aa, Gll, Gll, Gll, 4 Gll, Gll, Kh, Gll
Gll, Kh, Wwf, Gll, Gll, Gll, Gll, Gll, Xv, Gll, Gll, Gll, Gll, Gll, Wwf, Kh, Gll
Wwf, Kh, Gll, Wwf, Wwf^Bsb|, Wwf, Wwf, Gll, Xv, Gll, Wwf, Wwf, Wwf^Bsb|, Wwf, Gll, Kh, Wwf
Gll, Kh, Wwf^Bsb\, Gll, Gll, Gll, Wwf, Gll, Xv, Gll, Wwf, Gll, Gll, Gll, Wwf^Bsb\, Kh, Gll
Gd, Kh, Wwf, Gd, Gd, Gll, Wwf, Gll, Xv, Gll, Wwf, Gll, Gd, Gd, Wwf, Kh, Gd
Gd, Kh, Wwf, Hhd^Fp, Gd, Gd, Wwf, Gll, Xv, Gll, Wwf, Gd, Gd, Hhd^Fp, Wwf, Kh, Gd
Gd, Kh, Gs^Vh, Gll^Fp, Wwf, Wwf, Gd, Gd, Xv, Gd, Gd, Wwf, Wwf, Gll^Fp, Gs^Vh, Kh, Gd
Gd, Kh, Wwf, Wwf, Gd, Hhd, Gs, Gll^Fp, Xv, Gll^Fp, Gs, Hhd, Gd, Wwf, Wwf, Kh, Gd
Gs, Kh, Wwf, Gll^Fp, Hh, Gs, Gs^Vh, Gs, Xv, Gs, Gs^Vh, Gs, Hh, Gll^Fp, Wwf, Kh, Gs
Gs, 1 Kh, Gs^Fms, Wwf, Gs, Gs, Gs, Hh, Xv, Hh, Gs, Gs, Gs, Wwf, Gs^Fms, 3 Kh, Gs
Gs, Kh, Gs, Wwf, Wwf, Hh, Gll^Fp, Gs, Xv, Gs, Gll^Fp, Hh, Wwf, Wwf, Gs, Kh, Gs
Xv, Kh, Xv, Gs, Xv, Wwf, Xv, Gg^Ve, Xv, Gg^Ve, Xv, Wwf, Xv, Gs, Xv, Kh, Xv
Ql, Xv, Ql, Xv, Ql, Xv, Ql, Xv, Xv, Xv, Ql, Xv, Ql, Xv, Ql, Xv, Ql
Ql, Ql, Ql, Ql, Ql, Ql, Ql, Ql, Xv, Ql, Ql, Ql, Ql, Ql, Ql, Ql, Ql
