Gg, Gg, Gs, Gg, Gs, Gg, Gd, Gg, Xv, Gg, Gd, Gg, Gs, Gg, Gs, Gg, Gg
Gd, Gg, Gg, 2 Gg, Gg, Gg, Gg, Gg, Xv, Gg, Gg, Gg, Gg, 4 Gg, Gg, Gg, Gd
Gg, Gg, Gg, Gg, Gg, Gg, Gg, Gg, Xv, Gg, Gg, Gg, Gg, Gg, Gg, Gg, Gg
Gg, Gg, Gg, Gg, Gg, Gg, Gg, Gg, Xv, Gg, Gg, Gg, Gg, Gg, Gg, Gg, Gg
Gs, Gg, Gg, Gg, Qlf, Gg, Gg, Gg, Xv, Gg, Gg, Gg, Qlf, Gg, Gg, Gg, Gs
Gd, Gg, Qlf, Qlf, Gg, Qlf, Qlf, Gg, Xv, Gg, Qlf, Qlf, Gg, Qlf, Qlf, Gg, Gd
Gd, Gg, Qlf, Gg, Gg, Gg, Qlf, Gg, Xv, Gg, Qlf, Gg, Gg, Gg, Qlf, Gg, Gd
Gg, Gg, Gg, Gg, Gg, Gg, Qlf, Gg, Xv, Gg, Gg, Gg, Gg, Gg, Qlf, Gg, Gg
Gg, Gg, Gg, Gg, Qlf, Qlf, Gg, Gg, Xv, Gg, Gg, Gg, Qlf, Qlf, Gg, Gg, Gg
Gs, Gg, Gg, Gg, Qlf, Gg, Gg, Gg, Xv, Gg, Gg, Gg, Qlf, Gg, Gg, Gg, Gs
Gs, Gg, Gg, Gg, Gg, Gg, Gg, Gg, Xv, Gg, Gg, Gg, Gg, Gg, Gg, Gg, Gs
Gg, Gg, Gg, Gg, Qlf, Gg, Gg, Gg, Xv, Gg, Gg, Gg, Qlf, Gg, Gg, Gg, Gg
Gs, Gg, Gg, Gg, Gg, Gg, Gg, Gg, Xv, Gg, Gg, Gg, Gg, Gg, Gg, Gg, Gs
Gd, Rrc, Rrc, Kh, 1 Kh, Kh, Rrc, Rrc, Xv, Rrc, Rrc, Kh, 3 Kh, Kh, Rrc, Rrc, Gd
Gs, Gll, Gd, Gs, Gs, Gd, Gd, Gs, Xv, Gs, Gd, Gs, Gs, Gd, Gd, Gll, Gs
